1111111111111
10000000E0001
1001000000001
100100000C001
1001000111111
10011C11C0001
1001111111001
1000000000001
100P111111001
1111111111111
