1111111111111
10010000001C1
1000011111111
1P0001E100001
1111111111111
